################################
#..............................#
#..............................#
#..............................#
#..............................#
#................#######.......#
#..............................#
#..............................#
#..............................#
#..............................#
#..............................#
#..............................#
#..............................#
#..............................#
#..............................#
#.....############.............#
#..............................#
#..............................#
#..............................#
#..............................#
#............@.................#
#..............................#
#..............................#
################################