#######################################################################
#.....................................................................#
#.....................................................................#
#.....................................................................#
#.....................................................................#
#................#######.......######.......######.......######.......#
#.....................................................................#
#.....................................................................#
#.....................................................................#
#.....................................................................#
#.....................................................................#
#.....................................................................#
#..........................###........................................#
#.....................................................................#
#.....................................................................#
#.....############....................................................#
#.....................................................................#
#..................................#####################..............#
#......................##.............................................#
#............@........................................................#
#.....................................................................#
#.....................................................................#
#........................#######......................................#
#.....................................................................#
#.....................................................................#
#.....................................................................#
#.....................................................................#
#.....................................................................#
#......................................###############................#
#.....................................................................#
#.....############....................................................#
#.....................................................................#
#.....................................................................#
#.....................................................................#
#.....................................................................#
#........................###################..........................#
#.....................................................................#
#.....................................................................#
#.....................................................................#
#.....................................................................#
#.....................................................................#
#.....................................................................#
#.....############....................................................#
#.....................................................................#
#.....................................................................#
#.....................................................................#
#######################################################################